....XXX...
.XXX......
....X.....
.X.X......
.X.X.X....
pX...X@...
